root	meaning	modern_cognate
*miːn	fish	meen
*kuɖ	vessel	kud
*niːr	water	neer
*tuːl	weight	tool
*kal	cattle	kal
*iːl	house	il
*cem	copper	chem
*maːr	tree	mar
*nel	grain	nel
*kal	stone	kal
*tiː	fire	thee
*aal	person	aal
*maɳ	clay	man
*niːl	blue	neel
*ambu	arrow	ambu
*miːn	star	meen
*maɳ	earth	mann
*poːn	gold	pon
*ceːj	work	chey
*uppu	salt	uppu 