name	origin	meaning
dilmun	sumerian	sacred_land
meluhha	sumerian	black_land
magan	sumerian	copper_land
harappa	local	city_name
mohenjodaro	local	mound_dead
dholavira	local	white_well
kalibangan	local	black_bangles
lothal	local	mound_dead
sumer	sumerian	land
akkad	akkadian	city
babylon	babylonian	gate_god
uruk	sumerian	city
lagash	sumerian	city
nippur	sumerian	city
kish	sumerian	city
eridu	sumerian	city
ur	sumerian	city
girsu	sumerian	city
umma	sumerian	city 