root	meaning	modern_cognate
*miɳ	fish	min
*koŋ	vessel	kong
*baːr	water	bar
*tuːl	weight	tul
*gaːj	cattle	gai
*ɖoːm	house	dom
*reːn	copper	ren
*saːl	tree	sal
*maːɳ	grain	man
*kiːr	stone	kir
*juːm	fire	jum
*hoːr	person	hor
*ɖaːk	clay	dak
*neːl	blue	nel
*baːɳ	arrow	ban
*taːr	star	tar
*maːt	earth	mat
*siːn	gold	sin
*kaːr	work	kar
*luːp	salt	lup 