root	meaning	modern_cognate
*matsya	fish	matsya
*kalaśa	vessel	kalash
*āpaḥ	water	aap
*tulā	weight	tula
*go	cattle	gau
*gṛha	house	griha
*tāmra	copper	tamra
*vṛkṣa	tree	vriksha
*dhānya	grain	dhanya
*aśman	stone	ashma
*agni	fire	agni
*puruṣa	person	purusha
*mṛttikā	clay	mrittika
*nīla	blue	neela
*bāṇa	arrow	baan
*nakṣatra	star	nakshatra
*pṛthvī	earth	prithvi
*suvarṇa	gold	suvarna
*karman	work	karma
*lavana	salt	lavan 